11111111111
10100010101
10101110101
10000010001
11101010101
10101010101
10101110111
10000010121
11101010101
10001000001
11111111111