111111111111111111111111111111111111111111111111111
100000000000100010001010001000001000001000001000001
101110101110101010101010101010101110101110101011101
100000100010101010101000100010100000100000101010001
111011111010111010101110111110111111111111101110101
101010001010001010100010001000100000100000101000101
101010101011101010111011111011101110101111101010101
101000101010001010001000000010100010100000100010101
101111101110101011101110111110101110101110111111101
100010001000100010001010001000001000100010001000101
111010111011111110111011101111111011111011101010101
100010101010001000100000101000001000001000101010001
101010101010101011101110101011101111101111101011111
101000001010100010001000101000100000001000001000001
111111111011111111111011101110101111101011101110101
100000100010001000100000000000100010001000100010101
101110101110101010111111111111111010111111111010111
100010100000100010001000100000001010001000000010001
101010111011111110101110101111101011101011111111101
101010100010000010101000100000100010001000000010001
101010111110111010111010111110111010111110111010111
101010100000100010000010101000100010000010001000101
111010101010101111111010101011111111111011111111101
100010101010101000001010101000000010000010000010001
101111101110101111101110101110111010111110111010101
100010001000100000000000100010001010000010101000101
111010111011111111111111111010111011111010101111101
100010101010001000001010000000100010001000100000101
101110101010101011101010111111101111101111111010101
100010001010100000101010100000000000001000100010001
101111101010111111101010101111111111111110111011111
100000101010000010001000101000100010000000000010001
101110111010111110111011101010101010111111111110111
100010001010101000100010001010001010100000000010001
111010101010101011101110111011111010101111111111101
100010101010001000001010001000101000100000000010001
101110101011111111111011101110101111111011111010101
101010101010000010000000101000100010001000001000101
101010101010111010111111101011111010101111101111101
101010100010100010001000001010001010100000001000101
101010111111101111101010111010101011111110111110101
101010101000001000101010100010101000000010100000101
101010101010111010101010101110111111111010101111101
101010001010001010100010100010001000001010100010001
101011111011101011111110111010101111101010111010111
101000100010000010000000001000100000100000001000101
101110101110111110111111111111101110111111101011101
100010100010100000100010000000100010100010001000101
101010111010101110101011101110111010101010101110101
101002000010001000001000001000100010001000100010001
111111111111111111111111111111111111111111111111111
